F 0,100,100
C 100,100,0                          
NO textures/wall_north.xpm

SO textures/wall_south.xpm

WE textures/wall_west.xpm

EA textures/wall_east.xpm          

1111111111111111111111111111111111111111111111
1000000000000000000000000000100000011000100011
11111111111110000000000000000000000000000111
            100000000000000000000000000001
        1111000001000010001000011011001111111
            100000000000000000000000000001
            10W00100100110000000000000101
            100000000000000000000000000001
            100000000000000000000000000001
            10101000001111111111111111111
            100000000000000000000000000001
            100000000000000000000000000001
            100000000000000000000000000001
            100000000000000000000000000001
            100000000000000000000000000001
11111111100001011000010010110001111000010000011
            100000000000000000000000000001
            100000000000000000000000000001
            100000000000000000000000000001
     11111111100000000000000000000000000001
11111000000000000000000111111111111111111
    111111111111111111111111111111111
