F 100,100,0
C 225,30,0                          
NO /home/oel-bann/Desktop/Cube3D/file1

SO /home/oel-bann/Desktop/Cube3D/file2

WE /home/oel-bann/Desktop/Cube3D/file3

EA /home/oel-bann/Desktop/Cube3D/file4

        111111111111111111111111111     
        1111111111111111111111111111    
111111111111111111
100000000000000001
110001111111000001
1000000000001000001
100001000000100001
100000100W00010001
100000111111110001111
 111100000000000000001
10000000011111111111111
111111111111111111
 
 
 
 












