F 0,100,100
C 100,100,0                          
NO textures/wall_north.xpm

SO textures/wall_south.xpm

WE textures/wall_west.xpm

EA textures/wall_east.xpm 

1111111111111111111111111111111111111111111111
1000000000000000000000000000100000011000100011
1111111110000101111111010110001111000010000011
        1111000000000010001000011011001111111
            10W00000100111000001000000101
11111111111110101000001111111111111111111
111110000000000000000001
    111111111111111111111111111111111
