F 100,100,0
C 225,30,0                          
NO file1

SO file2

WE file3

EA file4

1111111111111111111111
1000000000000000000011
1111111110000101000011
10000000000010N0100001
1000000000001000100001
1000000000000101000001
1000000000000000000001
1111111111111111111111