F 0,100,100
C 100,100,0       

DOOR Mandatory/textures/door/img_040.xpm

NO Mandatory/textures/wall_north.xpm

SO Mandatory/textures/wall_south.xpm

WE Mandatory/textures/wall_west.xpm

EA Mandatory/textures/wall_east.xpm 


111 11111
11111111111111111111                                                    
1000000000000000000011111111111111111111111111111111111111111111111111110
11111111111111111100000000000000000000000000000000000000000000000000000001 
                10000011111111111111111111111111111111111111111111111000001
               100000001                                           100000001
              10000100001                                         10000000001
             100000 100011                   0                   1000000000001
            100000000000001                                     10000000S001001                                    
           10000000000000011                                   100000000000D0001
          1000000000000000001              111111111111       1000000000000100001
         100000000000000000001             100000000001      1000001111D1111000001
        10001000000101000000001            101111111101     10000000000000000000001
       1000010000010001000000001     111111101    10001    1000000001D11D1D100000001
      100000100000011100000000001    100001101    1011    100000000000000001000000001
     10000001000000000000000000001   101100001   1001    100000000000000000D0000000001
    1000000010000000000000000000001  101 1111   1001    1000000000000000000100000000001
   100000000100000111111110000000001 101        101    100000000000000111111110000000001111
 11000111111100001        10000000001101        101   1000000000000001        10000000001
10000100000000001          1000000000101        101111000000000000001          10000000001
1000100000010001            100000000001        100000000000000000001           1000000001
 1000110111000001            10000000011        111111000000000000001            100000001
  1000000000000001            10000001                1000000000000001            10000001
   10000000000000011111111    1000001                  10000000000000011111111    1000001
    10000000000000000000001    11111                    10000000000000000000001    11111
     100000000000000000000011  1                         100000000000000000000011  1
      10000000000000000000001  1                          10000000000000000000001  1
       1000000000000000000001  1                           1000000000000000000001  1
        100000000000000000001  1                            100000000000000000001 1
         1000000000000000001   1                             1000000000000000001   1
          10000000000000001   1                               10000000000000001   1
           100000000000001    1                                100000000000001    1
            1000000000001    1                                  1000000000001    1
             10000000001    1                                    10000000001    1
              100000001    1                                      100000001    1
               1000001                                             1000001
                10001                                               10001
                 101                                                 111
                  1                                                   1
                 101
                  1